CHIPS	CH IH P S
COFFEE	K AA F IY
COFFEE(2)	K AO F IY
COLA	K OW L AH
CONTINUE	K AH N T IH N Y UW
FLORALWATER	F L OW R AH L W AO T ER
FOLLOW	F AA L OW
ICETEA	AY S T IY
LAOGANMA	L EY AH G AE N M AH
MILK	M IH L K
NAPKIN	N AE P K IH N
NAVIGATION	N AE V AH G EY SH AH N
NO	N OW
NOODLE	N UW D AH L
PORRIDGE	P AO R AH JH
SAFEGUARD	S EY F G AA R D
TERMINAL	T ER M AH N AH L
TOOTHPASTE	T UW TH P EY S T
WATER	W AO T ER
YES	Y EH S
